0020020020001111111110002001002000111010111000200100200011101011100020010020001110101110002001002001111111111000300200200
0020000020301110101110011100011100111010111000200000200011101011100020000020001110101110011100011100111010111000200000200
0000000000001001110010011011101100000111000001001110010000030000000000111000001101110110000011100000000111000000100000100
0000000000001001000111011110011100000001110001100111000000003000000001110011000111000000011100111101110001001011000000000
0000000000000000000000000000000000000000000000000000000000000000000000000000000000000000000000000000000000000000000000000
